w b r r b r e w b b r b r b r
r r b b w r r b r b b w b r e
b w r b b r b e r w r r b r b
r b b r r r w r b b b b r e w
b b b w r r e r r b b r b w r
w r b w r r e r b r b b r b b
b b b w r r b r b w e r r b r
b r b e b r w b r b r b r r w
r w e b r b r b w r b r b r b
r r e r b r b r b w b r b b w
r b r b r b w r r w b r b e b
b w r b b b r e b b r w r r r
b b r w b w b b e r r r r b r
r b b b r r b b w e r b w r r
b r r r b r b e w b r b w r b
r b b w r e b r w r r b b r b
r w b e r b r b w b b b r r r
r r b b b r r b r b e b w w r
r w r r b b e w r b b b b r r
b w r r r r w r b b e b r b b
b b b r b r b w r w b r e r r
b b r r b w r b r e r b w r b
b b b r b r r r r b r w w e b
b r w r b w b b b r e r r b r
b b b b r r w r e b r r r b w
b e r b b r b w r b r b r w r
e r b r b r b r r r b w w b b
b b r r r b b e b w w b r r r
b b w r w r b r b e r b r r b
b r r e b r r w b b r w b b r
r b r r r e b r w b b b b w r
b b w r r r w r b b b r r e b
b b r e b w b r b r r b r w r
b b r w r r w e b b r r r b b
b w r w b r b r e b r b r b r
r r r r b w b b r b r b w b e
r r r b b r b r r w b e b w b
r b r r b b r b r b b w e w r
r w r b r e b r b b r r b b w
r w b r r b w b r r b b e b r
b b e r r b b w b r r r w b r
e w r w b r b r r r b b b r b
r b b r r r b w b r w b b e r
w r e r r r w b b r b b r b b
e b r b b r b r r b w r r w b
b r r e b r w w b b b r r r b
r r w b b w b r e r b r b b r
r b b w b r r r r b e b r w b
e b w r b b r r b r w b r r b
r b b r e r r r b b b w r w b
