g b r b b b r r w y g w y r e
w g b r w r g y r b b y r e b
r r g w b y w b r b b e y g r
b r r b e r w b g b r y y w g
r r w b w b r e g g b y b y r
y g r w b g e r b r b r b w y
r b r e g b r b y w y r b w g
w r r b r g e w r y b y g b b
r r r b w r b y w b y b e g g
w b r g y b w r b e b g y r r
e r g r b y y g b w w r b b r
g e y b w b r w b r b g y r r
g g r r b r e b r w y b w b y
w y g w e b b r b r r b y g r
g w r r w e y y r b g b r b b
r w g g b r e y y b w b r b r
r g b y b w g b r e r r y b w
b w r g r y b y r b b g r w e
b r r w b g y w b b r e y r g
e r g y r b g w b r b y b w r
b g y g b r r y w b r b r w e
g r w b e y b r g b r w r y b
w r r b g r w e r b b y g y b
e g y b w b y r r w r b g r b
b b r b r g g e r b w r y y w
b g y y b w w r g b b r e r r
w y r r r e b b b y g b w g r
r y b w r e g b g w r b b r y
y g b b y r b e r g w w r r b
y g e b r w g b r w r r b y b
