p w e w g r g r r b b y p y r
g y y e g r r r p r w b w p b
g e g y r b w y r r w b p r p
p r b p r b g y y r w r e g w
y p p r r r r g w e b y g b w
r e w g r y r b g p w p y r b
p g r y g p r y w e r r b b w
g r r b y p r w g y w b r e p
w p g r r b w g r y b e y p r
b y b p w r r r y e g p g w r
