e r b b b r r w b r w y y r r
r r e w r b r r b y y b r w b
w b r y r w r r y b r e r b b
b b y r r w b r y r e r w r b
b r y b r b e r b w r r r y w
b r w e r b y r r r w y b r b
r b y r y r e b w r r b r w b
b r r b r y b w e r b r y r w
r b y r r y w b r r b e b w r
b y r y r r r r e w b b r w b
b b r w w b b y r y r r r e r
y e r r r b b w w r b r y r b
r r b r r y r b y r w w b b e
e r b r w y r y w b b r r b r
w b r r b r y r y r b w b e r
y r b b e r r b r w y w r b r
r y e r w r r b y r r b b b w
w r r b b b y r w r b y r r e
b r b b r r r w r e b r y y w
b r r r w b b w r r e b y r y
r r y e w r r w b r b b r y b
w b r b b r r r y y b r e w r
w r b r r y r b b e b w r r y
w y w b r e r r b b r y r r b
e r b w r w r b b y r r y b r
w r r b y r y b w r b r e r b
b r r y r b w r r w b r y e b
r y r r y b r b e b r w r w b
r y r b r b w r b e b r w r y
y w r r y r b r b r w r b b e
w r b b r r y b r r y e w b r
r r b e w b r r r b y y w b r
r b r r e y r r w b b w b r y
r b b b w r e r r r r y y w b
b y b r e b r r r b w w y r r
r r b r r b y w b b r r w y e
r w e b r r y r w b b y r r b
e y b b w r b w y b r r r r r
y r b r w r r y w r b r b b e
r r w b e r b r r b y r y b w
r e w r y b r b r b w r b y r
r w e b r b b r y b y r r w r
w e r r y w r y r b b r b r b
b b r w r y e r r y w r r b b
y r r w b r r b r r e w b y b
b b r y r r b y e b r w r w r
r b r r e r r w y r b y b w b
b r w r y r b r r e b y r b w
b e r b r b r w y r r y b w r
w b r b r r r b r e r b y w y
